%%%%%%%%%%%%%%%%%%%%%%
% %%    ..  % %      %
%    %%%%%% % %%%%%% %
%%%%%%     P  %  .   %
%    % %%%%%% %% %%%%%
% %%%% %   .     %   %
%  .     %%% %%%   % %
%%%%%%%%%%    %%%%%% %
%.         %%        %
%%%%%%%%%%%%%%%%%%%%%%