%%%%%%%
%    P%
% %%% %
%..%..%
%%   %%
%.  %%%
%%%%%%%